###########################
  ##                   ##  
# ## ## ## ##### ## ## ## #
     ## ## ##### ## ##     
## # ## ## ##### ## ## # ##
                           
### ### ## ##### ## ### ###
        ## ##### ##        
#### ## ##       ## ## ####
     ##    #####    ##     
#### ## ## ##### ## ## ####
     ##    #####    ##     
#### ## ##       ## ## ####
        ## ##### ##        
### ### ## ##### ## ### ###
                           
## # ## ## ##### ## ## # ##
     ## ## ##### ## ##     
# ## ## ## ##### ## ## ## #
  ##                   ##  
###########################