###################
#         ##    #  
  # ### #    #  # #
# #  ## #### ##    
  ## #        # ###
# ##   ## # #   #  
     #        #   #
####   # # # #  #  
#### ##  # # # ####
  #  ## ##   #   ##
# # ###   ##  ##   
     #  #     #  ##
## #   ### ##   ###
   # #   #    #    
##   # #   #    ## 
###################    
